##########
#@..#.&..#
###.#.##.#
#...#.##.#
#.###..g.#
#.....##.#
########.#
##.z.....#
#..##.##.#
#x########